11111111111111111
11111111111111111
11111111111111111
11111111111111111
1111#########1111
1111#.......#1111
1111#....e..#1111
1111#..#.#..#1111
1111#...@.#.#1111
1111#..#.#..#1111
1111#.......#1111
1111#.......#1111
1111#.......#1111
1111#########1111
11111111111111111
11111111111111111
11111111111111111
11111111111111111