#########
#.......#
#...e...#
#..#....#
#...@.#.#
#.......#
#...#.e.#
#.e.....#
#########