###################
#11111111111111111#
#1111111111111#111#
#11111#11111111111#
#11111111111#11111#
#1111111#111111111#
#1111.........1111#
#1111.........1111#
#1111...#.#...1111#
#11#1....@.#..1111#
#1111...#.#...1111#
#1111.........1111#
#1111.........1111#
#1111.........1#11#
#11111111111111111#
#1111111111111#111#
#11#11111111111111#
#111111111##111111#
###################