.....####
........#
....@...#
#.......#
#########